111111111111111111111111111111
100000000000000000000000000001
1C0000111111111000000000000C11
100001111111111100000000000011
1000011P0000000000111111111111
100001100000000000000000000011
100001111111111111111000000011
100000000000000000000000000011
1C0000111111111111111111111C11
100000111111111111111111111111
100000000000000000000000000011
1C0000111111111111111110000011
100000111111111111111111000011
100000000000000000000000000011
1C0000111111111111111111111C11
100000111111111111111111111111
100000000000000000000000000011
1C0000111111111111111110000011
1000000000000000000000000E0111
111111111111111111111111111111
